NO	textures/betteriron.xpm
SO textures/name.xpm
EA textures/roughness.xpm
WE textures/nicewhitewall.xpm

F 220, 200,0
C 225,083,199

        11111111111111111111111111111
        11001110000000000000000000001
1111111100000000000001100111000111111
10000000000000000W0000001111111111001
1000000000000000000000001111111111001
1000000000000000000000000000000000001
1000000000000000000000000000000000001
1000000000000000000000001111111111111
1111111111111111111111111
