NO textures/cat.xpm
SO textures/cat2.xpm
EA textures/cat3.xpm
WE textures/cat4.xpm

1111111111111111111111111111111111111
1000000000011110000000000011111111001
1000000000111100000000000000001111001
1000000001111000000000000000011110001
1000000011110000000000000000111110001
1000000111100000000000000001111000001
1000001111000000000000000111100000001
1000011110000000000000001111000000001
1000011111111111110000011110000000001
1000000000000011110000111111110000001
1000000000000011110000000000000000001
100000000000001111000N000000000000001
1000000000000011110000000000000000001
1111111111111111111111111111111111111