NO textures/Walid.xpm
SO textures/Adamhorror.xpm
EA textures/WalidAdam.xpm
WE textures/WalidAdam.xpm

F 0, 0 ,0
C 0,0,0

1111111111111111111111111
1000111000000000000000001
1000000000000011001110001
10000000000000000W0000001
1000000000000000000000001
1000000000000000000000001
1000000000000000000000001
1111111111111111111111111
