NO textures/grass.xpm
SO textures/grass.xpm
EA textures/tree1694020873.xpm
WE textures/tree1694020873.xpm

F 85, 107,47
C 153, 201, 255

        11111111111111111111111111111
        11001110000000000000000000001
1111111100000000000001100111000111001
10000000000000000W0000001111111111001
1000000000000000000000001111111111001
1000000000000000000000000000000000001
1000000000000000000000000000000000001
1000000000000000000000001111111111111
1111111111111111111111111