NO textures/wood.xpm
SO textures/dark_blue_wood.xpm
WE textures/blue_wood.xpm
EA textures/red_wood.xpm

F 85, 107,47
C 153, 201, 255

        1111111111111111111111111
        1000000000110000000000001
        1011000001110000000000001
        1001000000000000000000001
111111111011000001110000000000001
100000000011000001110111111111111
11110111111111011100000010001
11110111111111011101010010001
11000000110101011100000010001
1000000000000000110000000001
10000000000000001101010010001
1100000111010101111101111000111
11110111011101010101111010N01
11111111111111111111111111111